25 25
1 10
19 10

1 1 1 1 1 1 1 1 1 1 1 1 1 1 1 1 1 1 1 1 1 1 1 1 1
1 2 0 0 0 4 1 3 0 0 0 0 2 1 1 1 1 1 2 0 1 0 0 2 1
1 0 4 0 0 0 1 0 0 4 0 0 0 0 0 1 0 0 0 0 0 0 0 0 1
1 0 0 0 0 0 1 2 0 0 0 0 0 1 0 0 0 1 0 0 1 0 0 0 1
1 1 0 1 1 0 1 1 1 1 1 1 1 1 0 0 0 1 1 0 1 2 0 5 1
1 0 0 0 1 0 0 0 0 0 0 0 0 1 0 0 0 1 1 0 1 1 0 1 1
1 5 0 2 1 0 0 0 0 0 0 0 2 1 0 0 0 1 0 0 0 1 0 1 1
1 1 1 1 1 1 1 2 1 1 1 0 1 1 2 0 3 1 2 0 0 1 0 1 1
1 1 1 1 0 0 0 0 0 0 0 2 1 1 1 1 1 1 0 0 0 1 0 0 1
1 6 0 0 0 0 0 0 0 0 0 0 0 0 0 0 0 0 0 0 0 1 0 2 1
1 6 0 0 0 0 0 4 0 0 0 0 0 0 0 0 0 0 0 0 0 1 0 1 1
1 6 0 0 0 0 0 0 0 0 0 0 2 0 0 0 0 4 0 0 2 1 0 1 1
1 1 1 1 0 0 0 0 0 0 0 0 1 1 1 1 1 1 1 1 1 1 0 1 1
1 1 1 1 1 1 1 0 1 1 1 0 1 2 0 0 0 0 1 4 0 0 0 3 1
1 2 0 0 0 0 0 2 0 0 0 0 1 0 0 0 1 0 1 2 0 0 0 0 1
1 0 1 1 1 1 1 0 1 0 1 0 1 0 0 3 1 0 0 0 0 0 0 0 1
1 0 1 2 0 0 0 0 1 0 1 0 1 1 0 1 1 1 1 1 1 1 1 4 1
1 0 1 0 4 0 0 0 1 0 1 0 1 1 0 1 2 0 0 0 0 0 0 0 1
1 0 1 0 0 3 0 0 1 0 1 0 0 1 0 1 0 0 0 0 1 1 0 1 1
1 0 1 0 1 1 1 0 1 0 1 0 0 0 2 0 0 0 0 0 1 0 0 0 1
1 2 0 0 0 0 0 2 1 0 1 0 0 1 0 1 0 0 0 0 1 0 0 2 1
1 1 1 1 1 1 0 1 1 0 1 2 1 1 0 1 4 0 0 2 1 1 1 1 1
1 0 0 2 0 0 0 0 0 0 1 0 1 1 0 1 1 0 1 1 1 5 0 0 1
1 5 0 0 0 0 4 0 0 2 0 0 0 0 0 0 0 0 0 0 0 0 0 2 1
1 1 1 1 1 1 1 1 1 1 1 1 1 1 1 1 1 1 1 1 1 1 1 1 1
